level 1
1 5,4 1
1
0 0,1 0,2 0,2 1,3 1
0 0
2
0 0,1 0,2 0,2 1,2 2
3 0
3
0 0,0 1,0 2,1 0,1 2
0 1
4
0 0,1 0,1 1,2 0,3 0
1 2
5
0 0,1 0,0 1,0 2,1 2
0 4
6
1 0,0 1,1 1,1 2,2 0
2 3
7
0 0,0 1,1 1,2 1,3 1
2 5
0
1 0,0 1,0 2,1 1,1 2
4 3
level 2
2 0,3 3
1
0 0,0 1,1 1,2 1,3 1
2 5
2
0 1,1 1,2 1,2 0,1 2
1 1
3
0 0,0 1,0 2,0 3,0 4
5 1
4
0 1,0 2,1 0,1 1,1 2
3 3
5
0 0,0 1,0 2,0 3,1 1
0 2
6
0 2,1 0,1 1,1 2,2 0
0 4
7
0 0,1 0,1 1,1 2,2 0
3 0
0
0 0,0 1,1 0,1 1,2 1
0 0
level 3
0 2,2 6
1
0 0,0 1,0 2,0 3,0 4
5 1
2
0 0,0 1,0 2,1 0,2 0
0 4
3
0 1,0 2,1 1,2 1,2 0
1 4
4
0 0,1 0,2 0,3 0,3 1,3 2
0 0
5
0 2,1 0,1 1,1 2,2 2
3 4
6
0 0,0 1,0 2,0 3,1 0
4 0
7
0 0,0 1,0 2,1 2
2 1
0
0 0,0 2,1 0,1 1,1 2
0 1
level 4
0 1,1 6,4 2
1
0 1,1 1,2 0,2 1
3 5
2
0 0,0 1,0 2,1 0,1 2,1 3
1 3
3
0 0,0 1,0 2,0 3,0 4,1 0
0 2
4
0 0,1 0
0 0
5
0 1,1 0,1 1,1 2,2 2
2 1
6
0 0,1 0,2 0,3 0,1 1,2 1
2 4
7
0 1,1 1,1 0,2 0,3 0
1 0
0
0 1,1 0,1 1,1 2,1 3
4 0
level 5
1 1,3 3,4 3
1
0 1,1 0,1 1,2 1,3 0,3 1
2 5
2
0 0,0 1,0 2,1 0,1 2
0 4
3
0 0,0 2,1 0,1 1,1 2
1 3
4
0 0,1 0,2 0,2 1,2 2
3 0
5
0 0,1 0,2 0
2 2
6
0 1,1 1,1 2,2 0,2 1
3 3
7
0 0,0 1,0 2,0 3,1 2
0 0
0
0 0,1 0,1 1,2 1,3 1
1 0
level 6
0 6,3 1
1
0 1,1 1,2 1,2 0
3 5
2
0 1,1 0,1 1,1 2,1 3
1 3
3
0 0,0 1,0 2,1 0,1 2,1 3
0 3
4
0 0,1 0,2 0,2 1
3 0
5
0 0,0 1,1 1,1 2,1 3
4 1
6
0 1,0 2,1 0,1 1,1 2
3 3
7
0 0,0 1,0 2,1 0,1 2
0 0
0
0 1,1 0,1 1,1 2,2 3,2 2
1 0
level 7
3 2,3 3,2 3
1
0 0,1 0,1 1,1 2,1 3,2 1,2 2
3 1
2
0 0,0 1,1 0,1 1
0 0
3
0 1,0 2,1 0,1 1,1 2
4 4
4
0 0,0 1,0 2,1 2,2 2
0 2
5
0 2,0 3,1 0,1 1,1 2
1 0
6
0 0,1 0,2 0,2 1
3 0
7
0 2,1 1,1 2,2 0,2 1,2 2
1 4
0
0 0,0 1,1 0
0 5
level 8
2 5,3 3,4 5
1
0 0,0 1,0 2,1 1,2 1
1 1
2
0 0,0 1,0 2,0 3,0 4,1 0
0 0
3
0 2,1 1,1 2,2 0,2 1
0 3
4
0 0,1 0,1 1,2 1,2 2
3 1
5
0 0,0 1,1 0,2 0,3 0,3 1
2 0
6
0 0,1 0,2 0
0 6
7
0 0,0 1,1 1,2 1
3 5
0
0 1,1 0,1 1,2 1,2 2
3 3
level 9
0 2,4 1,4 3
1
0 0,0 1,1 1,2 0,2 1
1 4
2
0 1,0 2,1 0,1 1,2 1,2 2
0 2
3
0 0,0 1,1 1,2 1,3 1
0 5
4
0 0,0 1,1 0
0 0
5
0 4,1 1,1 0,1 2,1 3,1 4
4 0
6
0 0,0 1,1 0,1 1
4 5
7
0 1,1 1,1 0,2 0,3 0
1 0
0
0 1,1 0,1 1,1 2,2 1
2 1
level 10
4 0,4 6,2 3
1
0 0,0 1,1 0,1 1,2 0,3 0
0 0
2
0 0,0 1,0 2,0 3,0 4,1 3
0 2
3
0 1,1 0,1 1
1 5
4
0 0,0 1,0 2
5 4
5
0 0,0 1,0 2,1 0,1 2,2 2
1 2
6
0 1,1 1,2 1,3 1,3 0
2 0
7
0 2,0 3,1 0,1 1,1 2
3 3
0
0 0,0 1,1 0,2 0,2 1
3 2